"filename", "language", "TypeScript", "Pug", "JSON", "comment", "blank", "total"
"d:\Lenovo\Documents\Project2CP\src\app.ts", "TypeScript", 74, 0, 0, 15, 12, 101
"d:\Lenovo\Documents\Project2CP\src\controller\applicationController.ts", "TypeScript", 30, 0, 0, 0, 3, 33
"d:\Lenovo\Documents\Project2CP\src\controller\applicationController\applyPost.ts", "TypeScript", 67, 0, 0, 0, 10, 77
"d:\Lenovo\Documents\Project2CP\src\controller\applicationController\checkOwnerApplication.ts", "TypeScript", 70, 0, 0, 0, 7, 77
"d:\Lenovo\Documents\Project2CP\src\controller\applicationController\getMyApplications.ts", "TypeScript", 27, 0, 0, 13, 10, 50
"d:\Lenovo\Documents\Project2CP\src\controller\applicationController\getMyPostsApplications.ts", "TypeScript", 10, 0, 0, 10, 5, 25
"d:\Lenovo\Documents\Project2CP\src\controller\applicationController\updateApplication.ts", "TypeScript", 29, 0, 0, 0, 4, 33
"d:\Lenovo\Documents\Project2CP\src\controller\authController.ts", "TypeScript", 43, 0, 0, 0, 4, 47
"d:\Lenovo\Documents\Project2CP\src\controller\authController\createAndSendToken.ts", "TypeScript", 23, 0, 0, 16, 2, 41
"d:\Lenovo\Documents\Project2CP\src\controller\authController\forgotPassword.ts", "TypeScript", 36, 0, 0, 18, 8, 62
"d:\Lenovo\Documents\Project2CP\src\controller\authController\isLoggedIn.ts", "TypeScript", 47, 0, 0, 4, 7, 58
"d:\Lenovo\Documents\Project2CP\src\controller\authController\login.ts", "TypeScript", 44, 0, 0, 5, 6, 55
"d:\Lenovo\Documents\Project2CP\src\controller\authController\logout.ts", "TypeScript", 8, 0, 0, 14, 1, 23
"d:\Lenovo\Documents\Project2CP\src\controller\authController\protect.ts", "TypeScript", 41, 0, 0, 52, 5, 98
"d:\Lenovo\Documents\Project2CP\src\controller\authController\resendEmailVerification.ts", "TypeScript", 44, 0, 0, 0, 10, 54
"d:\Lenovo\Documents\Project2CP\src\controller\authController\resetPassword.ts", "TypeScript", 32, 0, 0, 6, 7, 45
"d:\Lenovo\Documents\Project2CP\src\controller\authController\restrictTo.ts", "TypeScript", 16, 0, 0, 3, 4, 23
"d:\Lenovo\Documents\Project2CP\src\controller\authController\signup.ts", "TypeScript", 57, 0, 0, 4, 10, 71
"d:\Lenovo\Documents\Project2CP\src\controller\authController\signupAsWorker.ts", "TypeScript", 128, 0, 0, 21, 8, 157
"d:\Lenovo\Documents\Project2CP\src\controller\authController\switchRole.ts", "TypeScript", 39, 0, 0, 9, 4, 52
"d:\Lenovo\Documents\Project2CP\src\controller\authController\updateEmail.ts", "TypeScript", 26, 0, 0, 26, 5, 57
"d:\Lenovo\Documents\Project2CP\src\controller\authController\updatePassword.ts", "TypeScript", 26, 0, 0, 6, 5, 37
"d:\Lenovo\Documents\Project2CP\src\controller\authController\verifyEmail.ts", "TypeScript", 33, 0, 0, 0, 7, 40
"d:\Lenovo\Documents\Project2CP\src\controller\authController\verifyWorkerSignup.ts", "TypeScript", 17, 0, 0, 0, 3, 20
"d:\Lenovo\Documents\Project2CP\src\controller\dashboardController\applicationDashboard.ts", "TypeScript", 81, 0, 0, 22, 17, 120
"d:\Lenovo\Documents\Project2CP\src\controller\dashboardController\certificateDashboard.ts", "TypeScript", 52, 0, 0, 17, 6, 75
"d:\Lenovo\Documents\Project2CP\src\controller\dashboardController\dashboard1model.ts", "TypeScript", 160, 0, 0, 22, 24, 206
"d:\Lenovo\Documents\Project2CP\src\controller\dashboardController\dashboard2models.ts", "TypeScript", 182, 0, 0, 30, 22, 234
"d:\Lenovo\Documents\Project2CP\src\controller\dashboardController\dashboard3models.ts", "TypeScript", 179, 0, 0, 30, 22, 231
"d:\Lenovo\Documents\Project2CP\src\controller\dashboardController\dealDashboard.ts", "TypeScript", 52, 0, 0, 15, 7, 74
"d:\Lenovo\Documents\Project2CP\src\controller\dashboardController\generalDonutChart.ts", "TypeScript", 79, 0, 0, 66, 10, 155
"d:\Lenovo\Documents\Project2CP\src\controller\dashboardController\postDashboard.ts", "TypeScript", 34, 0, 0, 17, 7, 58
"d:\Lenovo\Documents\Project2CP\src\controller\dashboardController\reviewDashboard.ts", "TypeScript", 35, 0, 0, 11, 7, 53
"d:\Lenovo\Documents\Project2CP\src\controller\dashboardController\test.ts", "TypeScript", 0, 0, 0, 59, 1, 60
"d:\Lenovo\Documents\Project2CP\src\controller\dashboardController\userDashboard.ts", "TypeScript", 45, 0, 0, 18, 10, 73
"d:\Lenovo\Documents\Project2CP\src\controller\dashboardController\workerDashboard.ts", "TypeScript", 61, 0, 0, 18, 12, 91
"d:\Lenovo\Documents\Project2CP\src\controller\dealController.ts", "TypeScript", 33, 0, 0, 0, 2, 35
"d:\Lenovo\Documents\Project2CP\src\controller\dealController\checkOwnerDeal.ts", "TypeScript", 40, 0, 0, 2, 5, 47
"d:\Lenovo\Documents\Project2CP\src\controller\dealController\createDeal.ts", "TypeScript", 54, 0, 0, 0, 9, 63
"d:\Lenovo\Documents\Project2CP\src\controller\dealController\finishDeal.ts", "TypeScript", 101, 0, 0, 3, 14, 118
"d:\Lenovo\Documents\Project2CP\src\controller\dealController\getMyDeals.ts", "TypeScript", 34, 0, 0, 14, 6, 54
"d:\Lenovo\Documents\Project2CP\src\controller\dealController\updateDeal.ts", "TypeScript", 73, 0, 0, 3, 5, 81
"d:\Lenovo\Documents\Project2CP\src\controller\errorController.ts", "TypeScript", 76, 0, 0, 26, 15, 117
"d:\Lenovo\Documents\Project2CP\src\controller\handlerFactory.ts", "TypeScript", 91, 0, 0, 15, 13, 119
"d:\Lenovo\Documents\Project2CP\src\controller\portfolioPostController.ts\checkOwnerPortfolioPost.ts", "TypeScript", 19, 0, 0, 0, 2, 21
"d:\Lenovo\Documents\Project2CP\src\controller\portfolioPostController.ts\createPortfolioPost.ts", "TypeScript", 28, 0, 0, 0, 3, 31
"d:\Lenovo\Documents\Project2CP\src\controller\portfolioPostController.ts\deletePortfolioPost.ts", "TypeScript", 35, 0, 0, 2, 5, 42
"d:\Lenovo\Documents\Project2CP\src\controller\portfolioPostController.ts\getPortfolioPostById.ts", "TypeScript", 96, 0, 0, 0, 12, 108
"d:\Lenovo\Documents\Project2CP\src\controller\portfolioPostController.ts\likePortfolioPost.ts", "TypeScript", 59, 0, 0, 1, 4, 64
"d:\Lenovo\Documents\Project2CP\src\controller\portfolioPostController.ts\updatePortfolioPost.ts", "TypeScript", 89, 0, 0, 4, 3, 96
"d:\Lenovo\Documents\Project2CP\src\controller\postController.ts", "TypeScript", 21, 0, 0, 0, 3, 24
"d:\Lenovo\Documents\Project2CP\src\controller\postController\checkOwnerPost.ts", "TypeScript", 21, 0, 0, 0, 2, 23
"d:\Lenovo\Documents\Project2CP\src\controller\postController\createPost.ts", "TypeScript", 52, 0, 0, 0, 6, 58
"d:\Lenovo\Documents\Project2CP\src\controller\postController\deletePost.ts", "TypeScript", 90, 0, 0, 2, 8, 100
"d:\Lenovo\Documents\Project2CP\src\controller\postController\getMapPosts.ts", "TypeScript", 47, 0, 0, 2, 8, 57
"d:\Lenovo\Documents\Project2CP\src\controller\postController\getPost.ts", "TypeScript", 111, 0, 0, 0, 9, 120
"d:\Lenovo\Documents\Project2CP\src\controller\postController\savePost.ts", "TypeScript", 39, 0, 0, 0, 3, 42
"d:\Lenovo\Documents\Project2CP\src\controller\postController\updatePost.ts", "TypeScript", 105, 0, 0, 7, 8, 120
"d:\Lenovo\Documents\Project2CP\src\controller\reviewController.ts", "TypeScript", 29, 0, 0, 0, 2, 31
"d:\Lenovo\Documents\Project2CP\src\controller\reviewController\checkOwnerReview.ts", "TypeScript", 27, 0, 0, 0, 3, 30
"d:\Lenovo\Documents\Project2CP\src\controller\reviewController\createReview.ts", "TypeScript", 61, 0, 0, 15, 13, 89
"d:\Lenovo\Documents\Project2CP\src\controller\reviewController\deleteReview.ts", "TypeScript", 28, 0, 0, 1, 6, 35
"d:\Lenovo\Documents\Project2CP\src\controller\reviewController\getMyReviews.ts", "TypeScript", 30, 0, 0, 14, 8, 52
"d:\Lenovo\Documents\Project2CP\src\controller\reviewController\updateReview.ts", "TypeScript", 26, 0, 0, 5, 5, 36
"d:\Lenovo\Documents\Project2CP\src\controller\uploadController.ts", "TypeScript", 17, 0, 0, 0, 2, 19
"d:\Lenovo\Documents\Project2CP\src\controller\uploadController\deleteCloudinary.ts", "TypeScript", 13, 0, 0, 0, 3, 16
"d:\Lenovo\Documents\Project2CP\src\controller\uploadController\multerStorage.ts", "TypeScript", 67, 0, 0, 24, 10, 101
"d:\Lenovo\Documents\Project2CP\src\controller\uploadController\upload.ts", "TypeScript", 24, 0, 0, 0, 4, 28
"d:\Lenovo\Documents\Project2CP\src\controller\uploadController\uploadCert.ts", "TypeScript", 29, 0, 0, 6, 10, 45
"d:\Lenovo\Documents\Project2CP\src\controller\uploadController\uploadCertificate.ts", "TypeScript", 87, 0, 0, 8, 9, 104
"d:\Lenovo\Documents\Project2CP\src\controller\uploadController\uploadId.ts", "TypeScript", 35, 0, 0, 6, 9, 50
"d:\Lenovo\Documents\Project2CP\src\controller\uploadController\uploadImages.ts", "TypeScript", 41, 0, 0, 22, 4, 67
"d:\Lenovo\Documents\Project2CP\src\controller\uploadController\uploadPfp.ts", "TypeScript", 32, 0, 0, 6, 11, 49
"d:\Lenovo\Documents\Project2CP\src\controller\userController.ts", "TypeScript", 54, 0, 0, 0, 4, 58
"d:\Lenovo\Documents\Project2CP\src\controller\userController\ToggleFavoriteWorker.ts", "TypeScript", 63, 0, 0, 0, 6, 69
"d:\Lenovo\Documents\Project2CP\src\controller\userController\editMe.ts", "TypeScript", 80, 0, 0, 16, 8, 104
"d:\Lenovo\Documents\Project2CP\src\controller\userController\editMeUser.ts", "TypeScript", 83, 0, 0, 17, 16, 116
"d:\Lenovo\Documents\Project2CP\src\controller\userController\getAllUsers.ts", "TypeScript", 39, 0, 0, 1, 7, 47
"d:\Lenovo\Documents\Project2CP\src\controller\userController\getMap.ts", "TypeScript", 47, 0, 0, 2, 8, 57
"d:\Lenovo\Documents\Project2CP\src\controller\userController\getMe.ts", "TypeScript", 6, 0, 0, 0, 2, 8
"d:\Lenovo\Documents\Project2CP\src\controller\validationRequestController.ts", "TypeScript", 166, 0, 0, 14, 13, 193
"d:\Lenovo\Documents\Project2CP\src\controller\workerController.ts", "TypeScript", 52, 0, 0, 0, 3, 55
"d:\Lenovo\Documents\Project2CP\src\controller\workerController\bestWorkers.ts", "TypeScript", 56, 0, 0, 1, 10, 67
"d:\Lenovo\Documents\Project2CP\src\controller\workerController\certificatesController.ts", "TypeScript", 217, 0, 0, 18, 21, 256
"d:\Lenovo\Documents\Project2CP\src\controller\workerController\editMeWorker.ts", "TypeScript", 21, 0, 0, 11, 5, 37
"d:\Lenovo\Documents\Project2CP\src\controller\workerController\getMyRequests.ts", "TypeScript", 60, 0, 0, 0, 8, 68
"d:\Lenovo\Documents\Project2CP\src\controller\workerController\getSavedPosts.ts", "TypeScript", 44, 0, 0, 0, 5, 49
"d:\Lenovo\Documents\Project2CP\src\controller\workerController\portfolioPostsController.ts", "TypeScript", 24, 0, 0, 0, 3, 27
"d:\Lenovo\Documents\Project2CP\src\controller\workerController\workerCRUD.ts", "TypeScript", 107, 0, 0, 9, 12, 128
"d:\Lenovo\Documents\Project2CP\src\easyhome-project2cp-firebase-adminsdk-oypl8-e6a828557a.json", "JSON", 0, 0, 13, 0, 1, 14
"d:\Lenovo\Documents\Project2CP\src\firebase.ts", "TypeScript", 16, 0, 0, 7, 6, 29
"d:\Lenovo\Documents\Project2CP\src\models\Application.ts", "TypeScript", 75, 0, 0, 19, 9, 103
"d:\Lenovo\Documents\Project2CP\src\models\Certificate.ts", "TypeScript", 56, 0, 0, 1, 5, 62
"d:\Lenovo\Documents\Project2CP\src\models\Deal.ts", "TypeScript", 91, 0, 0, 2, 11, 104
"d:\Lenovo\Documents\Project2CP\src\models\Like.ts", "TypeScript", 16, 0, 0, 0, 5, 21
"d:\Lenovo\Documents\Project2CP\src\models\Notification.ts", "TypeScript", 120, 0, 0, 96, 10, 226
"d:\Lenovo\Documents\Project2CP\src\models\PortfolioPost.ts", "TypeScript", 47, 0, 0, 1, 6, 54
"d:\Lenovo\Documents\Project2CP\src\models\Post.ts", "TypeScript", 71, 0, 0, 2, 7, 80
"d:\Lenovo\Documents\Project2CP\src\models\Review.ts", "TypeScript", 94, 0, 0, 7, 16, 117
"d:\Lenovo\Documents\Project2CP\src\models\User.ts", "TypeScript", 63, 0, 0, 151, 3, 217
"d:\Lenovo\Documents\Project2CP\src\models\UserDoc.ts", "TypeScript", 36, 0, 0, 9, 4, 49
"d:\Lenovo\Documents\Project2CP\src\models\Worker.ts", "TypeScript", 113, 0, 0, 45, 14, 172
"d:\Lenovo\Documents\Project2CP\src\models\WorkerDoc.ts", "TypeScript", 34, 0, 0, 7, 4, 45
"d:\Lenovo\Documents\Project2CP\src\models\data.ts", "TypeScript", 148, 0, 0, 77, 15, 240
"d:\Lenovo\Documents\Project2CP\src\models\validationRequest.ts", "TypeScript", 96, 0, 0, 16, 10, 122
"d:\Lenovo\Documents\Project2CP\src\routes\applicationRouter.ts", "TypeScript", 43, 0, 0, 1, 12, 56
"d:\Lenovo\Documents\Project2CP\src\routes\authRouter.ts", "TypeScript", 36, 0, 0, 4, 5, 45
"d:\Lenovo\Documents\Project2CP\src\routes\certificateRouter.ts", "TypeScript", 27, 0, 0, 1, 8, 36
"d:\Lenovo\Documents\Project2CP\src\routes\dashboardRouter.ts", "TypeScript", 110, 0, 0, 6, 15, 131
"d:\Lenovo\Documents\Project2CP\src\routes\dealRouter.ts", "TypeScript", 48, 0, 0, 2, 11, 61
"d:\Lenovo\Documents\Project2CP\src\routes\modRouter.ts", "TypeScript", 195, 0, 0, 28, 35, 258
"d:\Lenovo\Documents\Project2CP\src\routes\notificationRouter.ts", "TypeScript", 19, 0, 0, 0, 8, 27
"d:\Lenovo\Documents\Project2CP\src\routes\portfolioRouter.ts", "TypeScript", 42, 0, 0, 2, 8, 52
"d:\Lenovo\Documents\Project2CP\src\routes\postRouter.ts", "TypeScript", 49, 0, 0, 2, 14, 65
"d:\Lenovo\Documents\Project2CP\src\routes\reviewRouter.ts", "TypeScript", 36, 0, 0, 0, 11, 47
"d:\Lenovo\Documents\Project2CP\src\routes\userRouter.ts", "TypeScript", 86, 0, 0, 11, 20, 117
"d:\Lenovo\Documents\Project2CP\src\routes\validationRequestRouter.ts", "TypeScript", 16, 0, 0, 0, 7, 23
"d:\Lenovo\Documents\Project2CP\src\routes\workerRouter.ts", "TypeScript", 102, 0, 0, 11, 21, 134
"d:\Lenovo\Documents\Project2CP\src\server.ts", "TypeScript", 53, 0, 0, 65, 19, 137
"d:\Lenovo\Documents\Project2CP\src\serverOnline.ts", "TypeScript", 43, 0, 0, 7, 11, 61
"d:\Lenovo\Documents\Project2CP\src\utils\APIFeatures.ts", "TypeScript", 28, 0, 0, 87, 8, 123
"d:\Lenovo\Documents\Project2CP\src\utils\appError.ts", "TypeScript", 13, 0, 0, 0, 2, 15
"d:\Lenovo\Documents\Project2CP\src\utils\catchAsync.ts", "TypeScript", 17, 0, 0, 2, 3, 22
"d:\Lenovo\Documents\Project2CP\src\utils\email.ts", "TypeScript", 77, 0, 0, 78, 18, 173
"d:\Lenovo\Documents\Project2CP\src\views\_footer.pug", "Pug", 0, 10, 0, 0, 1, 11
"d:\Lenovo\Documents\Project2CP\src\views\_header.pug", "Pug", 0, 14, 0, 0, 1, 15
"d:\Lenovo\Documents\Project2CP\src\views\_reviewCard.pug", "Pug", 0, 10, 0, 0, 1, 11
"d:\Lenovo\Documents\Project2CP\src\views\account.pug", "Pug", 0, 55, 0, 0, 5, 60
"d:\Lenovo\Documents\Project2CP\src\views\base.pug", "Pug", 0, 20, 0, 8, 4, 32
"d:\Lenovo\Documents\Project2CP\src\views\emails\_style.pug", "Pug", 0, 258, 0, 0, 0, 258
"d:\Lenovo\Documents\Project2CP\src\views\emails\baseEmail.pug", "Pug", 0, 36, 0, 3, 6, 45
"d:\Lenovo\Documents\Project2CP\src\views\emails\passwordReset.pug", "Pug", 0, 6, 0, 0, 2, 8
"d:\Lenovo\Documents\Project2CP\src\views\emails\verifyEmail.pug", "Pug", 0, 17, 0, 0, 1, 18
"d:\Lenovo\Documents\Project2CP\src\views\emails\welcome.pug", "Pug", 0, 16, 0, 0, 1, 17
"d:\Lenovo\Documents\Project2CP\src\views\error.pug", "Pug", 0, 8, 0, 0, 1, 9
"d:\Lenovo\Documents\Project2CP\src\views\login.pug", "Pug", 0, 14, 0, 0, 1, 15
"d:\Lenovo\Documents\Project2CP\src\views\overview.pug", "Pug", 0, 41, 0, 0, 5, 46
"d:\Lenovo\Documents\Project2CP\src\views\tour.pug", "Pug", 0, 76, 0, 1, 16, 93
"Total", "-", 7022, 581, 13, 1583, 1074, 10273